physical_entity	entity
abstract_entity	entity
thing	entity
object	entity
matter	physical_entity
process	physical_entity
phenomenon	physical_entity
attribute	abstract_entity
measure	abstract_entity
relation	abstract_entity
item	thing
artifact	thing
part	thing
whole	object
natural_object	object
structure	object
solid	matter
liquid	matter
gas	matter
plasma	matter
change	process
motion	process
transition	process
property	attribute
quality	attribute
trait	attribute
tool	artifact
structure	artifact
artwork	artifact
instrument	artifact
hammer	tool
screwdriver	tool
saw	tool
building	structure
bridge	structure
tower	structure
painting	artwork
sculpture	artwork
music	artwork
piano	instrument
guitar	instrument
violin	instrument
